111111111111111
1P0000C000000C1
1000000000C01
1C00000000000E1
1000000000C0001
1000C00000000000000001
10000000C000001
100000000000C01
1C0000001
111111111111111
