11111
1PP01
1C0E1
10001
11111
