11111
1P0C1
1E0E1
10001
11111
