1111111
1PP0C01
1000001
1C00EE1
1000001
1111111
