1111111111
1P00C000C1
100000CC01
1C000000E1
1000000001
1000000001
100C000001
1000000001
10000C0001
1111111111
