111111111111111
100000C000000C1
1000000000C0001
1C00000000000E1
1000000000C0001
1000C0000P00001
10000000C000001
100000000000C01
1C000000000C001
111111111111111
