1111111111
1P000000C1
10000C0001
1C000000E1
1000000001
1000000001
100C000001
1000000001
10000C0001
1111111111
