1111111111
10000000C1
10000C0001
1C00000001
100P0000E1
10000000E1
100C000001
1000000001
10000C0001
1111111111
